11111111
10000001
10000001
10000001
10001001
11001001
10001011
11111111